wwwwwwwwwwwwwwwwwwwwwwwwwwwwwwwww
w...................w..........gw
w=====..............ww.........gw
w++A++.........................gw
w+++++.........................gw
w..............................gw
wwwwwwwwwwwwwwwwwwwwwwwwwwwwwwwww
w...................w..........gw
w-----..............ww.........gw
w__B__.........................gw
w_____.........................gw
w..............................gw
wwwwwwwwwwwwwwwwwwwwwwwwwwwwwwwww
