wwwwwwwwwwwwwwwwwwwwwwwwwwwwwwwww
w..............................gw
w=====.........................gw
w++A++.........................gw
w+++++.........................gw
w..............................gw
wwwwwwwwwwwwwwwwwwwwwwwwwwwwwwwww
w..............................gw
w-----.........................gw
w__B__.........................gw
w_____.........................gw
w..............................gw
wwwwwwwwwwwwwwwwwwwwwwwwwwwwwwwww
