wwwwwwwwwwwwwwwwwwwwwwwwwwwwwwwwwwwwwww
w....................................gw
w==A==...............................gw
w+++++...............................gw
w....................................gw
wwwwwwwwwwwwwwwwwwwwwwwwwwwwwwwwwwwwwww
w....................................gw
w--B--...............................gw
w_____...............................gw
w....................................gw
wwwwwwwwwwwwwwwwwwwwwwwwwwwwwwwwwwwwwww
