wwwwwwwwwwwwwwwww
w............k..w
w...............w
w...............w
w....A......W...w
w...........w...w
w.......wwwww...w
w.......e.......w
w...w...........w
w...w...........w
www.............w
w..........www..w
w.....ww.w......w
w........w......w
w....ww.........w
w....w.....B....w
w.w.ww......w...w
w...........w...w
w..s........w...w
wwwwwwwwwwwwwwwww