wwwwwwwwwwwwwwwwwwwwwwww
w...........e..........w
w......................w
w.k....................w
w......................w
wwww................wwww
w.........ww.ww........w
w......................w
w..w................w..w
w..w................w..w
w..w.....A..s..B....w..w
wwwwwwwwwwwwwwwwwwwwwwww