wwwwwwwwwwwwwwwwwwwwwwww
w...........e..........w
w......................w
w..........www.........w
w......................w
w.ww.....A.....B....ww.w
w......................w
w......................w
w......w..........wwwwww
w...s..w............k..w
w......W...............w
wwwwwwwwwwwwwwwwwwwwwwww