2.............................
000...........................
000...........................
..............................
..............................
..............................
..............................
.0...0...0...00...0...0...0...
...0...0...0....0...0...0...0.
..............................
........A............B........