........................h.......
.....p.........A................
..h........b........b...........
...........bbb....bbb........b..
.............bbbbbb.......p..b..
.............................b..
...............h................
...b............................
...b..h.........................
...b.........bbbbbb.........h...
...........bbb....bbb...........
...........b........b.........h.
...............B................
.......p........................