............................h.....
...bbb.........p..................
...b..............................
.........bbb........bbb........h..
......b.......bbbb.......b........
.p....b........b.........b........
......b..A.....b.....B...b.....p..
......b........b.........b........
......b........b.........b........
........bb....bbbb....bb..........
..h..........................b....
........................h..bbb....
...............p..................
........h.........................