cc.c..cccc..c.cc
..c.cc....cc.c..
................
.......B........
................
................
................
................
................
.......A........
................
..b.bb....bb.b..
bb.b..bbbb..b.bb