ccccccccccccccc
...............
.c.c.......c.c.
.......B.......
...............
.....bb.bb.....
.......b.......
...............
b...b..b..b...b
b...b..c..b...b
b.b.b..b..b.b.b
c.c.c..c..c.c.c
c...c..b..c...c
c...c..c..c...c
...............
.......c.......
.....cc.cc.....
...............
.......A.......
.b.b.......b.b.
...............
bbbbbbbbbbbbbbb