cc..c.ccc.c..cc
...............
.......B.......
...............
b..b.bb.bb.b..b
...............
.c.c.cc.cc.c.c.
...............
...b..c.b..c...
...............
.b.bb.b.b.bb.b.
...............
c..c.cc.cc.c..c
...............
.......A.......
...............
bb..b.bbb.b..bb