c.c.c.c...c.c.c.c
.................
c..cc.......cc..c
........B........
.b.............c.
c...............b
.................
..b.b..bbb..b.b..
.b.............b.
c...............c
b...............b
c....c.....b....c
b...............b
.c.............c.
..c.c..ccc..c.c..
.................
b...............c
.c.............b.
........A........
b..bb.......bb..b
.................
b.b.b.b...b.b.b.b