wwwwwwwwwwwwwwwwwwww
wA..bb.b...b...0..bw
wbb..b..b....b...b.w
w.bb..b.b..b...b.bbw
w..bbb..1bbbb.....bw
wb.....bbbb0..bbb..w
wbb.b...b..b.b..bb.w
w.b...b....b..b..bbw
wb..1...b...b.bb..Bw
wwwwwwwwwwwwwwwwwwww