wwwwwwwwwwwwwwwww
w.......w.......w
w.1...0...1.....w
wa.............bw
w.A...1...0...B.w
wc.............dw
w.....0...1...0.w
w.......w.......w
wwwwwwwwwwwwwwwww