wwwwwwwwwwwwwwwww
w..w.........w..w
w.....0...1.....w
wb.............aw
w..0...A.B...1..w
wc.............dw
w.....0...1.....w
w..w.........w..w
wwwwwwwwwwwwwwwww