wwwwwwwwwwwwwwwwwwww
w++++++xx++++++....w
w+++++++++++++xx...w
w++x+++++++++..Ax@.w
w+++xx+x++++....x..w
w+++++xx+++........w
w++++++x++..x......w
w++++++++...x......w
w++x++++....xx.....w
w+*xB++........x...w
w+++xx..........x..w
w++++......xxx.....w
wwwwwwwwwwwwwwwwwwww
