wwwwwwwwwwwwwwwwwwww
w+++++++x+.........w
w+*+++++++....xx...w
w++xx+++++......x..w
w+++++++++.x....x..w
w+++++++++.x.......w
w++++B++++....A....w
w+++++++x+.........w
w++x++++x+.........w
w++x++++++.....xx..w
w+++xx++++.......@.w
w+++++++++.x.......w
wwwwwwwwwwwwwwwwwwww
