.........%......
&&.......%......
&&.......%%%%...
................
.......AB.......
................
...++++.......--
......+.......--
......+.........