wwwwwwwwwwwwwwwwww
w....w.x..ww..x..w
w.x.w....w..x..x.w
ww..ww....w....w.w
w...x....A...x.w.w
w....w.wwwwwww..xw
w.xx.....w..ww...w
w....w...w...w.x.w
w..www...w..x...ww
w..w..x..B....w..w
w.x......ww...w..w
wwwwwwwwwwwwwwwwww