wwwwwwwwwwwww
w..11.x.11..w
wh1.1.h.1.1hw
w..1h1.1h1..w
wh...1.1...hw
www.11.11.www
w.1h.....h1.w
w.1.1A.B1.1.w
wwwwwwwwwwwww
