wwwwwwwwwwwww
w.1...1...1.w
w..h..x..h..w
wh1.wwhww.1hw
w1h1..1..1h1w
wwww..1..wwww
w1..1...1..hw
wB...1.1...Aw
wwwwwwwwwwwww
