wwwwwwwwwwwww
wB....1....Aw
ww..1w.w1..ww
w..1wh.hw1..w
w.1wh.1.hw1.w
w1wh.1h1.hw1w
whh..h1h..hhw
w.h1..x..1h.w
wwwwwwwwwwwww
