wwwwwwwwwwwww
w00.ww......w
w0..........w
w......w....w
w.A...b...B.w
w....w......w
w..........1w
w......ww.11w
wwwwwwwwwwwww