wwwwwwwwwwwwwww
w..w...www..r.w
w....r........w
0....ww.......1
0.A....b....B.1
0.......ww....1
w.............w
w..r.w..w.r..ww
wwwwwwwwwwwwwww