wwwwwwwwwwwwwwwwwwww
w..................w
w...w..........w...w
w...w..........w...w
w...w....A..wwww...w
w...wwww...B...w...w
w...w..........w...w
w...w..........w...w
w.1................w
wwwwwwwwwwwwwwwwwwww