wwwwwwwwwwwwwwwwwwww
w..w........ww.....w
w.ww....0...w...w..w
w...A.www.....www..w
w..ww...ww...ww....w
w.........w........w
www..wwww.1..ww....w
w........w....wwB..w
w....w...w.........w
wwwwwwwwwwwwwwwwwwww