wwwwwwwwwwwwwwww
w..w.....ww....w
w..w..w..-w-w..w
w...A.www---w1.w
www.w...ww.ww..w
w.2.....w......w
w..wwww....ww..w
w...++..w..wwB.w
wwwwwwwwwwwwwwww