hhhhhhhhhhhhhhhhh
hq____q___q____qh
h__bh___h___h0__h
h__hb___w___hhh_h
h_____A_w_B_____h
h_hhh___w___bh__h
h__0h___h___hb__h
hu____u___u____uh
hhhhhhhhhhhhhhhhh