wwwwwwwwwwwwwwww
w....w.........w
w.B..d....A..www
w....w..w......w
w.+..w..ww..c..w
wwwwww..cw.....w
w.w..c.........w
w.w....www...*.w
w......w.......w
wwwwwwwwwwwwwwww