wwwwwwwwwwwwwwwwwwwwwwwwwwwwwwww
w..............d...............w
w..............................w
w..............................w
w..............................w
w..............................w
w..............................w
w..............................w
w..............................w
w..............................w
w..............................w
w..........A........B..........w
wwwwwwwwwwwwwwwwwwwwwwwwwwwwwwww