wwwwwwwwwwwwwwwwwwwwwwwwwwwwwwww
w..............f...............w
w..............................w
w..............................w
w..............................w
w..............................w
w..............................w
w..............................w
w..............................w
w..............................w
w..............................w
w..........A........B..........w
wwwwwwwwwwwwwwwwwwwwwwwwwwwwwwww