wwwwwwwwwwwwwwwwwwwwwwwwwwwwwwww
w..............s...............w
w..............................w
w..............................w
w..............................w
w..............................w
w..............................w
w..............................w
w..............................w
w..............................w
w..............................w
w..........A........B..........w
wwwwwwwwwwwwwwwwwwwwwwwwwwwwwwww