wwwwwwwwwwwwwwwwwwwwwwwwwwwwwwww
w..............h...............w
w..............................w
w..............................w
w..............................w
w..............................w
w..............................w
w..............................w
w..............................w
w..............................w
w..............................w
w..........A........B..........w
wwwwwwwwwwwwwwwwwwwwwwwwwwwwwwww