wwwwwwwwwwwww
wawawawawawaw
we..e...e..ew
ww..e...e..ww
we...A+B...ew
ww..e...e..ww
we..e...e..ew
wbwbwbwbwbwbw
wwwwwwwwwwwww