wwwwwwwwwwwww
wewewewewewew
wr..r...r..rw
ww..a...b..ww
we...A+B...ew
ww..b...a..ww
wr..r...r..rw
wawawawbwbwbw
wwwwwwwwwwwww