wwwwwwwwwwwww
wbbbbeeeaaaaw
wb..r...r..aw
ww..r...r..ww
wb...A+B...aw
ww..r...r..ww
wb..r...r..aw
wbbbbeeeaaaaw
wwwwwwwwwwwww