wwwwwwwww
wbwbwawaw
wr..a..ew
ww..e..ww
we.A+B.ew
ww..e..ww
we..b..rw
wewawbwew
wwwwwwwww