wwwwwwwww
wrwbwawrw
wr.aeb.rw
ww..e..ww
wa.A+B.bw
ww..e..ww
w..bea..w
wawewewbw
wwwwwwwww