wwwwwwwwwwwwwwwwwwwww
w........lur........w
w........lAr........w
w........ldr........w
wwwwwwwwwwwwwwwwwwwww
w1a.......w.......b0w
w1a...............b0w
w1a...............b0w
w1a...t...w...t...b0w
w1a.......w.......b0w
wwwwwwwwwwwwwwwwwwwww
w........lur........w
w........lBr........w
w........ldr........w
wwwwwwwwwwwwwwwwwwwww
