wwwwwwwwwwwww
w.....w.....w
w.x.x.w.o.o.w
w.....w.....w
w.x.......o.w
wwwww.d.wwwww
w.o.......x.w
w....A.B....w
w.o.......x.w
wwwwwwwwwwwww