wwwwwwwwwwwwwwwwwww
w........wx.......w
w.T......wx...c...w
w........wx.......w
w.....wxxxxxxxxxxxw
wxxxxxwwwwwwwwwwwww
wwwwwxwxxxxxxxxxxxw
w....xw....xw.....w
w....xw....xw...A.w
w....xw....xw.....w
wwwwwwwwwwwwwwwwwww