wwwwwwwwwwwwwwwwwwwwww
w.......xww.......A..w
w...c...x....ww......w
w.......x....ww......w
wxxxxxxxwwwwwwwxxxxxxw
w.......wwwwwww......w
w.T..................w
w....................w
wwwwwwwwwwwwwwwwwwwwww
