wwwwwwwwwwwwwwwwwwwwwww
wddddd..,,,,,,,..dddddw
wd......,,,,,,,......dw
w...d...,,,,,,,...d...w
w.d.....,,,,,,,.....d.w
w.......,,,,,,,.......w
w..r....,,,,,,,....l..w
w.......,,,,,,,.......w
w....r..,,,,,,,..l....w
w.......,,,,,,,.......w
w...A...,,,,,,,...B...w
wwwwwwwwwwwwwwwwwwwwwww
