wwwwwwwwwwwwwwwwwwwwwww
wd......,,,,,,,......dw
w.....r.,,,,,,,.d.....w
w...d...,,,,,,,...l...w
w.......,,,w,,,.......w
w..r....,,,w,,,....l..w
w.r.....,,,w,,,.....l.w
w......d,,,w,,,d......w
w.......,,,,,,,.......w
w.......,,,,,,,.......w
w...A...,,,,,,,...B...w
wwwwwwwwwwwwwwwwwwwwwww
