wwwwwwwwwwwwwww
w....-----++++w
w.A..-----++++w
w....-----++++w
w...w-----w+++w
w..w0--*--1w++w
w...w-----w+++w
w....-----++++w
w....-----++B+w
w....-----++++w
wwwwwwwwwwwwwww
