wwwwwwwwwwwwwwwwwwwwwwwww
w...........e...........w
w......w.........w......w
w......w.........w......w
w......w....d....w......w
www.....w...w...w.....www
w.........wwwww.........w
w.......................w
w...w...............w...w
w...w...w.......w...w...w
w...wwwww.......wwwww...w
w.A.w.......p.......w.B.w
wwwwwwwwwwwwwwwwwwwwwwwww