wwwwwwwwwwwwwwwwwwwwwwwww
w..w........e........w..w
w.......................w
w.....w...........w.....w
w..wwww.....p.....wwww..w
w..w........w........w..w
w..w......wwwww......w..w
wwww.................wwww
w.......................w
w...www...........www...w
w...w...............w...w
w.d.w....A.....B....w...w
wwwwwwwwwwwwwwwwwwwwwwwww