wwwwwwwwwwwwwwwwwwwwwwwwwwww
wx.........................w
w..wwww....www......w......w
w..w................wwwwww.w
w..W.......w...ww..........w
w..........w.x..w..........w
w.wwwwww...................w
w......w.....www...B..A....w
w...x..w...................w
w......w...................w
wwwwwwwwwwwwwwwwwwwwwwwwwwww
