....wwwww
...ww.0.w
..ww.10.w
.ww.1..Aw
ww.1..www
w.1..ww..
w00.ww...
wB..w....
wwwww....
