wwwwwwwwwww
ww.......ww
ww1wwwww.ww
w..w...w0ww
wB...A.w0ww
ww1ww.ww0ww
ww........w
ww1wwww...w
ww......www
wwwwwwwwwww
