wwwww....
wA..w....
w.11w.www
w.1.w.w0w
www.www0w
.ww....0w
.w.B.w..w
.w...wwww
.wwwww...
