wwwwwwwwwwwwwww
w......x......w
w......1......w
w.0.........0.w
w..0.......0..w
w...0.....0...w
w.1...A.B...1.w
w.............w
w....00.00....w
w...0.....0...w
w.0000.1.0000.w
wwwwwwwwwwwwwww