wwwwwwwwwwwwwww
w00....x....00w
w.............w
w.10.......01.w
wwwww.....wwwww
w.............w
w.0...www...0.w
w....ww.ww....w
w......0......w
w...A.....B...w
wwwwwwwwwwwwwww