wwwwwwwwwwwwwww
w.A.w..x..w.B.w
w.0.w.....w.0.w
w.....www.....w
w.............w
w.1.........1.w
w0ww...0...ww0w
w0...........0w
w0..ww...ww..0w
w0000..1..0000w
wwwwwwwwwwwwwww