wwwwwwwwwwwww
w++++++++0..w
w+.......0..w
w+A.....00..w
w+B.b..000.gw
w+....0000..w
w+1..00000..w
w+++000000..w
wwwwwwwwwwwww
