wwwwwwwwwwwww
w++++++++0..w
w+.......0..w
w+A.....00..w
w+B.bbb000.gw
w+......00..w
w+1......0..w
w++++++++0..w
wwwwwwwwwwwww
