wwwwwwwwwwwwww
w...........ww
w..dpppppppp3w
w.0.p........w
w...p..0.0...w
w.0.p........w
w...ppppppd..w
w...r....p...w
w......0.p...w
w.H......p.V.w
w......0.p...w
w........p...w
w...tppppp...w
w...w....l...w
w...w..0.0...w
w...w........w
wwwwwwwwwwwwww