wwwwwwwwwwwwwwwwwwwwwww
w.......l..H..........w
wtppppppp..0.dppppppp3w
w.......p.....p.......w
w..0.0..p..0..p..0.0..w
w.......p.....p.......w
w.......p..0..p.......w
w......uppppppp.......w
w..........0..l.......w
w.......0.....0.......w
w..........V..........w
wwwwwwwwwwwwwwwwwwwwwww