wwwwwwwwwwwwwwwwwwwwwww
w.....................w
w..dppppppppppppppppp3w
w...p...0...0...0.t...w
w...p.0...0H.V0...p...w
w...p...0...0...0.p...w
w...pppppppppppppppu..w
w...r.................w
wwwwwwwwwwwwwwwwwwwwwww