wwwwwwwwwwwwwwwwwwwwwwwwwwwwwwwwwww
w...........rBaaa++b++++++++++aaadw
w...........+....................+w
w2Aaaa++b++++++++++aaa3..........+w
w+..........+.........+..........+w
w+..........+.........+..........bw
w+..........+.........+..........aw
w+..........ua++++++bbb++++++++++lw
w+....................a...........w
w1a+++++bbb+++++++++++4...........w
wwwwwwwwwwwwwwwwwwwwwwwwwwwwwwwwwww
