++++++++++++++++
1...............
................
0......A........
0......B........
................
1...............
++++++++++++++++