wwwwwwwwwwwwwwwwwwwwwww
w....2++b++A+++++3....w
w....+...........+....w
w....b...........a....w
w....+...........+....w
w....r++b++B+++++d....w
w....+...........+....w
w....b...........a....w
w....+...........+....w
w....+...........+....w
w....+...........+....w
w....b...........a....w
w....1+++++++a+++4....w
w....+...........+....w
w....+...........+....w
w....b...........a....w
w....u+++++++a+++l....w
wwwwwwwwwwwwwwwwwwwwwww
