++++++++++++++++
0...............
0......A........
0......B........
0...............
++++++++++++++++