wwwwwwwwwwwwwwwwww
w2+bAb+3.........w
w+.....+.........w
w+..r+bBb+d......w
w+..+..a..+......w
w+..+..2+++++3...w
w+..+.....a..+...w
w+..+.....r+++++dw
w+..+........a..+w
w1a+++++bbb++4..+w
w...+...........aw
w...ua++++++bbb+lw
wwwwwwwwwwwwwwwwww
