++++++++++
..A.......
0.........
..B.......
++++++++++