wwwwwwwwwwwwwwwww
w...t...w.......w
w.00000.w1..1...w
w.......w...1.y.w
w00...00w1..1111w
w.......w.......w
w..000..w.11....w
w.......w..1....w
wwwwdwwwwwwwfwwww
w...9...A...8...w
w...b.......n...w
w..bsb.....nxn..w
w...b...B...n...w
wwwwwwwwwwwwwwwww