wwwwwwwwwwwwwwwwwwwwwww
w.......w......w......w
w.t000..w...1..w.2..22w
w.......w...1.ywu2....w
wwwwdwwwwwwfwwwwwwgwwww
w...9......8......7...w
w.......b..n..m....m..w
w....A.bsbnxnmzm.B....w
w.......b..n..m.......w
wwwwwwwwwwwwwwwwwwwwwww