wwwwwwwwwwwwwwwwwwwwwwwwwwwwww
w.0......0.....w...1.....1...w
w.0......0.000.w.111..y..111.w
w.0..0.........w.1.........1.w
w....0..t...000w...111.111...w
w..0.0.........w.....1.1.....w
wwwwdwwwwwwwwwwwwwwwwwfwwwwwww
w...9.................87.....w
w..b....n....m..wwwwwwwgwwwwww
w.bsb..nxn..mzm.w....22......w
w..b....n....m..w...22...22..w
w....A..B.......w......222u..w
w...............w..22........w
wwwwwwwwwwwwwwwwwwwwwwwwwwwwww