wwwwwwwwwwwwwwwww
w.......w.......w
w.00.00.w11..111w
wt0...0tw.......w
w00...00w.1.11..w
w...t...w....11.w
w..000..w111..1.w
w.......w.....1.w
wwwwdwwwwwwwfwwww
w...9...m...8...w
wA..b..mzm..n..Bw
w..bsb..m..nxn..w
w...b...7...n...w
wwwwwwwwgwwwwwwww
w.............2.w
w..2222...2...2.w
w....2....222...w
w....2..........w
wwwwwwwwwwwwwwwww