wwwwwwwwwwwwwwwwwwwwwwww
w.0.....w1.....w...2...w
w.0...t.w1.111.w.222...w
w.0..0..w....y.w.2..u..w
w....0..w.1.111w...222.w
w..0.0..w......w.....2.w
wwwwdwwwwwwfwwwwwwwgwwww
w...9......8.......7...w
w..b........n.......m..w
w.bsb...A..nxn..B..mzm.w
w..b........n.......m..w
wwwwwwwwwwwwwwwwwwwwwwww