wwwwwwwwwwwwwwww
w..............w
w..........B...w
w..............w
w..............w
w..............w
w..............w
w..............w
w..A...........w
w..............w
w..............w
w..............w
w..............w
wwwwwwwwwwwwwwww
