-----A----
-.+.+a+.+-
-+.+.+.+.-
-.+141+.+-
-+.+.+.+.-
-.+.+.+.+-
-+.+eye+.-
-.+.+.+.+-
-+.+.b.+.-
-----B----