-----A----
-.+.+a+.+-
-+.+.+.+.-
-.+1414.+-
-+.+1+.+.-
-.+.+e+.+-
-+.yeye+.-
-.+.+.+.+-
-+.+.b.+.-
-----B----