wwwwwwwwwwwwwwwwwwww
w..2.....__.....2..w
w........__........w
w...+....__....=...w
w..a.....__.....b..w
w..a...2.__.2...b..w
w...A....__....B...w
w..a...3.__.3...b..w
w..a.....__.....b..w
w...+....__....=...w
w........__........w
w..3.....__.....3..w
wwwwwwwwwwwwwwwwwwww