wwwwwwwwwwwwwwwwwwww
w....1...__...1....w
w.a.+.2..__..2.=.b.w
w.aa..a..__..b..bb.w
w.a.+....__....=.b.w
w.....A..__..B.....w
w.a.+....__....=.b.w
w.aa..a..__..b..bb.w
w.a.+.2..__..2.=.b.w
w....1...__...1....w
wwwwwwwwwwwwwwwwwwww