wwwwwwwwwwwwwwwwwwww
w....3...__...3....w
w...+.2..__..2.=...w
w.aa..a..__..b..bb.w
w.aa...1.__.1...bb.w
w...A.a..__..b.B...w
w.aa...3.__.3...bb.w
w.aa..a..__..b..bb.w
w...+.2..__..2.=...w
w....1...__...1....w
wwwwwwwwwwwwwwwwwwww