wwwwwwwwwwwww
w+++++++++++w
w+.l.l.l.l.+w
w+.........+w
w+A.a.k.b.B+w
w+.........+w
w+++.+++++++w
wwww0wwwwwwww
w+++.+++++++w
w+.........+w
w+.sss.....+w
w+++++++++++w
wwwwwwwwwwwww