wwwwwwwwwwwww
w+++++++++++w
w+.s..s..m.+w
w+.........+w
w+A.a...b.B+w
w+.........+w
w+.l..l..m.+w
w+++++++++++w
wwwwwwwwwwwww