wwwwwwwwwwwwwwwwwwwwwww
w..A....w.+.=.w....B..w
w.......w.....w.......w
w.w.....w..h..w.....w.w
w.w.......www.......w.w
w.........w.w.........w
w..r..w.........w..r..w
w..........1..........w
w...u..s.......s..3...w
w...w.www..2..www.w...w
w...w....ww.ww....w...w
wwwwwwwwwwwwwwwwwwwwwww