wwwwwwwwwwwwwwwwwwwwww
w+w................w-w
w+..................-w
w+..................-w
w+..................-w
w+wA..............aw-w
w+....o........o....-w
w+w................w-w
w+..................-w
w+..................-w
w+..................-w
w+w................w-w
wwwwwwwwwwwwwwwwwwwwww