wwwwwwwwwwwwwwwwwwwwww
w+..................-w
w+..................-w
w+..................-w
w+..................-w
w+A................a-w
w+.........o........-w
w+..................-w
w+..................-w
w+..................-w
w+..................-w
w+..................-w
wwwwwwwwwwwwwwwwwwwwww