wwwwwwwwwwwwwwwwwwwwww
w+w................w-w
w+..................-w
w+..................-w
w+..................-w
w+wA..............aw-w
w+.........o........-w
w+w................w-w
w+..................-w
w+..................-w
w+..................-w
w+w................w-w
wwwwwwwwwwwwwwwwwwwwww