wwwwwwwwwwwwwwwwwwwwwwwww
w-w.s..................+w
w-.....................+w
w-.....................+w
w-.....................+w
w-....................A+w
w-w...........s........+w
w-.....................+w
w-.....................+w
w-.....................+w
w-.....................+w
w-w...................s+w
wwwwwwwwwwwwwwwwwwwwwwwww