wwwwwwwwwwwwwwwwwwwwwwwwwwwwwwww
w.....d........d........a....a.w
wttttttttttttttttttttttttttttttw
w..............................w
w...xxxx.......................w
w..........xx...x.........x....w
w...............x..xx..........w
w......................A.......w
w...xx...x.........x...........w
w.........xxx.........x....xx..w
w...............x.x............w
w....xx.......x..........x.....w
i..............................o
wwwwwwwwwwwwwwwwwwwwwwwwwwwwwwww