wwwwwwwwwwwwwwwwwwwwwwwwwwwwwwww
w.....d........a........a....d.w
wttttttttttttttttttttttttttttttw
w..............................w
w...x........x............xx...w
w.......xxxx...................w
w.............x.....A........x.w
w.xx.......x.........x.........w
w...............x.......xxx....w
w....x.....xxx....x............w
w......................x.......w
w.......x.........x............w
i..............................o
wwwwwwwwwwwwwwwwwwwwwwwwwwwwwwww