wwwwwwwwwwwwwwwwwwwpwwwww
w.....l.................w
w.......................w
w......................dw
w..A...1................w
w...v..1.v............r.w
w......1.........v......w
w.......................w
w..v....................w
w.......................w
wu.........2222......3..w
w....................3..w
w....................g..w
wwwwwwwwwwwwwwwwwwwwwwwww