wwwwpwwwwwwwwwwwwwwwwwwww
w.......d...............w
w..v......6666........r.w
w.......................w
w............v.....5....w
w..................5....w
w.......g...A......5....w
w.....v.................w
w.......................w
wu.........4444.........w
w.......................w
w..........v.......d....w
w.......................w
wwwwwwwwwwwwwwwwwwwwwwwww