wwwwwwwwwwwwwwwwwwwwwwww
w......................w
w..c...w..w..c.....c...w
w.......c........w.....w
w...w..................w
w........A.......c.....w
w..........c...........w
w....w...wwwwwww.......w
w....c.............g...w
w......................w
wwwwwwwwwwwwwwwwwwwwwwww