wwwwwwwwwwwwwwwwwwwwwwww
w......w...............w
w..w.....A...w....c..g.w
w........c.............w
w..c...........c.......w
w.w....c.........w.....w
w.........wc...........w
w....c.................w
w....w.......c...w.....w
w.w....c............w..w
wwwwwwwwwwwwwwwwwwwwwwww