wwwwwwwwwwwwwwwwwwwwwwww
w......................w
w..c.........c.....c...w
w.......c..............w
w......................w
w........A.......c.....w
w..........c...........w
w......................w
w....c.............g...w
w......................w
wwwwwwwwwwwwwwwwwwwwwwww