wwwwwwwwwwwwwwwwwwwwwwww
w......................w
w..c...w.....c.....w.A.w
w.......c......w.......w
w..w...............w...w
w.c..............c.....w
w..........w...w...w...w
w....w.................w
w....g...w.......c.....w
w...........w..........w
wwwwwwwwwwwwwwwwwwwwwwww