wwwwwww
wKwwwww
w000..w
w0.01.w
w0111.w
w.1A1.w
w01.1.w
wwwwG.w
wwwwwww