wwwwwwwwwwwww
wA....10001Gw
w.111110001.w
w1100000001.w
w0001111111.w
w1111.......w
w......11111w
w11111110001w
wM0000000000w
w0000000010Kw
wwwwwwwwwwwww