wwwwwwwwwwwww
w...00.00...w
w.w100K001w.w
w.w.00000.w.w
w.1.00M00.1.w
w.w.ww1ww.w.w
w...........w
w1wwww1wwww1w
w.....AG....w
wwwwwwwwwwwww