wwwwwwwwwwwwwwwwwwwwwwwwwwwwwwwwwww
w...........d.........d...........w
w...........b.........b...........w
wsbbbbbbbbbbjbbbbbbbbbjbbbbbbbbbbdw
w...........b.........b...........w
w...........b.........b...........w
wwwww...dbbbjbbbbbbbbbjbbbjbd.....w
ww1ww.......b.........b...b.......w
w4A2w.......b.........d...jbbbp...w
ww3ww.......d.............d.......w
wwwwwwwwwwwwwwwwwwwwwwwwwwwwwwwwwww
