wwwwwwwwwwwwwwwwwwwwwwww
w.....................0w
w.wwwwwwwwwwwwwww...c.0w
w...c............w.c..0w
w..w.wwwwwwwwww.c.0....w
wccw...........ww...w..w
w..w....c.c....www.www.w
w..w.....c.....wr......w
wccw...c.......wr......w
w..w...b..w0000...c...0w
w..w......w..........00w
wA.w......w.........00gw
wwwwwwwwwwwwwwwwwwwwwwww