wwwwwwwwwwwwwwwwwww
w,,,,,,,,g,,,,,,,,w
w,wwwwwwwwwwwwwww,w
we.e.w.ee.ee.w.e.ew
w.wwwwee..e..ww.www
we.e.w.ee.ee.w.e.ew
w.e.e..ee.ee...e.ew
wee..we..ee..we..ew
wwwwwww,,,,,wwwwwww
w,,,,,,,,A,,,,,,,,w
wwwwwwwwwwwwwwwwwww