wwwwwwwwwwwwwwwwwww
wg,,,,,,e........4w
w.......w,,,,,,,,,w
w.......w,,,,,,,,,w
w.......w,,,,e,,,,w
w.......w.........w
w.......w.........w
w.......w.........w
w,,A,,,,,,,,,,eee,w
w,,,,,,,,,,,,,,,,,w
wwwwwwwwwwwwwwwwwww