wwwwwwwwwwwwwwwww
wA......grwwwwwww
w....k...gwbg.www
w.........wg..www
w.........w...eww
w.........w...www
wg........w...brw
wbg.......d...gbw
wwwwwwwwwwwwwwwww