wwwwwwwwwwwww
wed...w...brw
www.w.g....bw
w...w..O.w..w
wb.......w..w
wrb....O.w..w
wwwwwwwwww.ww
w...gw......w
wgA.....w..gw
wbgk.w....grw
wg....gb...gw
wwwwwwwwwwwww
