wwwwwwwwwwwwwwwwwwwwwwwwwwww
w.........A................w
w..........................w
w..........................w
w..........................w
wwwwwwwwwwwww.wwwwwwwwwwwwww
w.......................w..w
w.....1...1.1..1.......w...w
w.....................w..0.w
w....1..1..1.........w.0...w
w...................w..0...w
wwwwwwwwwwwwwwwwwwwwwwwwwwww