wwwwwwwwwwwwwwwwwwwwwwwwwwwww
w...3...c................c..w
w.tttttttt....t.ttt...2.....w
w.............t.............w
wctt.ttt......t...ttttttttt.w
w......t....................w
w...5..t.c...A....tt..ttt...w
w.......................6...w
w..t......t........t........w
w..t.....t...ttt..t.ttttt...w
w..t.1...t...t.t..t.c.......w
w..t.....t...t.t..t....4....w
w..t..c.....................w
wwwwwwwwwwwwwwwwwwwwwwwwwwwww