wwwwwwwwwwwwwwwwwwwwwwwwwwwwwwwwwwwwwwwwwwwwwwww
wA.............................w..............gw
wh.............................w..............gw
wh.............................wwwwwwwwwwwww..gw
wh.......w....................................gw
wh.......w....................wwww.wwwwwwwwwwwgw
wh.......w....................................gw
wh.......w....................................gw
wwwwwwwwwwwwwwwwwwwwwwwwwwwwwwwwwwwwwwwwwwwwwwww