wwwwwwwwwwwwwwww
wA__..___1__0..w
w___.._______..w
w010..___w___..w
w........._1_..w
w..__..........w
w.._1..........w
w..__.....___..w
w..ww________..w
w...._____1wwwww
w....1_____....w
w0__...........w
w___.0.._w.....w
www..._________w
w....._000...__g
wwwwwwwwwwwwwwww
