wwwwwwwwwwwwwwww
w___0........__w
w............__w
w............3_w
w2...........__w
w_............1w
w_.............w
wA__0..._w.....w
wwwww..._w.....w
wg......_wwww..w
w_w_....3w__0..w
w_w0.....w.....w
w_w............w
w_www....___...w
w_.......32____w
wwwwwwwwwwwwwwww