wwwwwwwwwwwwwwwww
w...............w
w...A..b...g....w
w.m.c..c.....b..w
w....0000.......w
w.b.............w
w....c.....m..g.w
w....g....c..b..w
w.......000w....w
wwwwwwwwwwwwwwwww