wwwwwwwwwwwwwwwww
w..........w....w
w..b.......w....w
w.gc....c.....m.w
w....b...0.0....w
w.........b.....w
w...c..w.....c..w
w..m...w..g.....w
w...A..w........w
wwwwwwwwwwwwwwwww