wwwwwwwwwwwwwwwwwwwwwwww
ww....w............0000w
ww..w.w....w.wwwwwwwww.w
ww.....ww..............w
ww.w...................w
ww.......ww.......0....w
w......ww...0..........w
w........000...0.0.....w
w......ww.....0........w
w...A..........wwwwwww.w
wwwwwwwwwwwwwwwwwwwwwwww