wwwwwwwwwwwww
w...........w
w..11...2.2.w
w....1......w
w...a.....2.w
w.......h...w
w....1....b.w
w......1....w
w........A..w
wwwwwwwwwwwww