wwwwwwwwwwwwwwwwww
w.A...3..wb...4..w
w.ch...3.w.h..4..w
w..4211.2....a433w
w...b..4.w2..1142w
w.2..h..12...24..w
w2.112w2a2.1h2.2xw
wd.2..h.4..w..b..w
w3...13.d4..2.4d.w
w.ah....4w..2....w
wwwwwwwwwwwwwwwwww