wwwwwwwwwwwwwwwwww
w.....2..wc...4..w
w.bha..2.w.h..4.xw
w..3143.1.....422w
w...b..4.w1..2231w
w.1..h..312.a13..w
w1.111w1...1h1.1.w
wd.1..h.3..w..b..w
w2...22.c3..1.3c.w
w...A...4...1....w
wwwwwwwwwwwwwwwwww