wwwwwwwwwwwwwwwwww
w..x..3..wc...4..w
w.bh...3.w.h..4..w
w..4244.2.....433w
w...b..4.w2..3342w
w.2..h..423..24..w
w2.222w2.2.2h2.2.w
wd.2..h.4..w..b..w
w3...33.c4..2.4cAw
w..h....4...2....w
wwwwwwwwwwwwwwwwww