wwwwwwwwwwwwwwwwww
w..a..2..w....4..w
w.bh...2.w.h..4.xw
wwwwwww.1..2..422w
w...b..4..1wwww..w
w.1...w.31...13..w
w1.111w..1.1.1.1.w
wd.1..w.3.ww..wwww
w22...w..3..1.3c.w
w...A...4...1....w
wwwwwwwwwwwwwwwwww