wwwwwwwwwwwwww
wA....ww.....w
w.....ww.....w
w..o..ww..t..w
w.....ww.....w
www.wwwwwwlwww
w.....ww.....w
w.....ww.....w
w..b......p..w
w....kww.....w
wwwwwwwwwwwwww