wwwwwwwwwwwwww
w......w.....w
w...t..w...o.w
w....wwwww...w
w............w
w......A.....w
w..wwww......w
w....kw......w
w..b..wwwwlw.w
w.....wp.....w
wwwwwwwwwwwwww