wwwwwwwwwwwwwww
www..b......www
www.........www
wwwwwwwdwwwwwww
w....r........w
w.............w
w..........r..w
wwwwwwwwwwwdwww
w.....w.......w
w..g..w..y....w
w.g...w..y....w
w.....d.......w
wwdwwwwwwwwwwww
w...A........1w
w............0w
wwwwwwwwwwwwwww
