wwwwwwwwwwwwwww
wwwwww.....y..w
wwwwww..y.....w
wwwwwwwdwwwwwdw
wA..w....g..w.w
w...d.......w.w
w0.1w......gw.w
wwwwwwwwwwwww.w
w...w.......w.w
w...w...r...w.w
w...w.......w.w
w...d.r.....w.w
w...w.........w
w.b.wwwwwwwwwww
w.............w
wwwwwwwwwwwwwww
