wwwwwwwwwwwwwwwwwwwwwwwwwwwwwww
w...w.....................A...w
w...w.wwwwwwwww.wwwwwwwwwwwww.w
w...w.........w...............w
w...w....t....w...t...w.......w
w..ww.................w.......w
w..........wwww.......w...t...w
w...t...w.....t..w....w.......w
w.......w........w............w
w.....wwwwww.....w....wwwwww..w
w.......wgw.........t....w....w
w.......w.w....wwww......w....w
w...wwww.................w....w
w................t............w
wwwwwwwwwwwwwwwwwwwwwwwwwwwwwww
