c...f....r........c
...................
...................
z..................
.....r.............
...................
.........a.........
...................
...................
.............r....x
...................
...................
c........r....v...c