c...f....r........c
...................
...................
z..................
.....r.......r.....
...................
.........a.........
...................
...................
.....r.......r....x
...................
...................
c........r....v...c