wwww333wwwwwwwwwwwwwwwwwwwwwwww
...............................
..............................2
.A.............................
..............................2
...............................
...............................
........00000000...............
.....0000000000000....000000...
.....0.0......000000000..000...
.......0000..00000000...00000..
.......000000000000000..000000.
......0000000000000000000000000
wwwwwwwwwwwwwwwwwwwwwwwwwwwwwww