c...f....r........c
...................
...................
z..................
.....r.......r.....
...c...........c...
.........a.........
...................
...c...........c...
.....r.......r....x
...................
...................
c........r....v...c