wwwwwwwwwwwwwwwwwwwwwwwwwww
w........w...w....w.......w
w..ww.w......www.w.1w.....w
w.w....ww.0.w..w.ww.www...w
w....w.w.ww.w....ww..0ww..w
w.....w..w.1.....ww...w...w
w....www....ww...w.w...w..w
w....w........w.w...w.ww..w
ww.ww..www...www10....w...w
w....ww...ww......ww.w.w..w
w......wwwww...www..w.ww..w
wwwwww.w01..www...ww...ww.w
wwwwwwwwwwwwwwwwwwwwwwwwwww
wA.......................ew
wwwwwwwwwwwwwwwwwwwwwwwwwww
