wwwwwwwwwwwwwwwwwwwwwwwwwww
w0000000000000000000000000w
w1111111111111111111111111w
w....m......m.............w
w.....m........m..m.......w
w........m..........m..m..w
w.....................m...w
wwwwwwwwwwwwwwww..wwwwwwwww
w.........................w
w.........................w
w.........................w
w.........................w
w.........................w
wA.......................ew
wwwwwwwwwwwwwwwwwwwwwwwwwww
