wwwwwwwwwwwwwww
w......w....1.w
w.A..*.w......w
w......a......w
w......w..+...w
w....0.w......w
wwwwwwwwwwwwbww
w......c......w
w../..3w...-..w
w......w......w
wwwwdwww......w
we.....w.2....w
wwwwwwwwwwwwwww