wwwwwwwwwwwwwww
w...1.........w
w.........+...w
wwbwww.w......w
w....w.wwwwwcww
w....w.w......w
w.2..w.w./....w
w....w.w......w
w..wwwawwwww..w
w.-w.0.*.d.w..w
w..w.....w.w..w
w..w..A..wew.3w
wwwwwwwwwwwwwww