wwwwwwwwwwwwwww
w......A......w
w...1......*..w
w.............w
w...0......+..w
w.............w
wwwwawwwwwwwwww
w.....w.....wew
w.....w.....d.w
wwbwwwwwwcwwwww
w...-......2..w
w3....../.....w
wwwwwwwwwwwwwww