wwwwwwwwwwwwwww
w.e.w....w...ew
w.b.w.cc.w.bb.w
w111w0000w1111w
w............bw
w...........bAw
www........bbbw
www0000w11wwwww
www.cc.w..e0gww
wwwe...wwwwwwww
wwwwwwwwwwwwwww
