wwwwwwwwwwwww
wx.h11...11.w
w.111.h.111.w
w.h...1..1h1w
w.1..w.wwwwww
w.h1.w.11111w
w1.ww.1.1..hw
w.1w11.1...Aw
wwwwwwwwwwwww
