wwwwwwwwwwwww
wA..1.1h..1.w
w..1...11...w
w1.....1.1h.w
www.whhwwwwww
w..1...1....w
w1..1....11.w
w..h11..1h1xw
wwwwwwwwwwwww
