wwwwwwwwwwwww
wh1........Aw
wwww..w.1.1.w
w.1.h1.w1..1w
w.11.h1.w.1.w
w...11h1.w..w
w.1...1h..www
wxh11.......w
wwwwwwwwwwwww
