wwwpwwwwwwwwwwwwwwwwwwwww
w..................l....w
w.......................w
w.......................w
wr......................w
w.......................w
w....................b..w
w...........A...........w
w..t....................w
w.......................w
w...........h..........sw
wu......................w
w.........r.............w
wwwwwwwwwwwwwwwwwwwwwwwww
