wwwwwwwwwwwpwwwwwwwwwwwww
w.............w.........w
w.............w.........w
w.............w..h......w
w....u........w.........w
w.............w..s....b.w
w.............w.........w
w....b......A..........tw
w......................tw
w.......................w
w......d................w
w....................d..w
w.......................w
wwwwwwwwwwwwwwwwwwwwwwwww
