wwwwwwwwwwwwwwwwwwwwwwwwwwww
wA.w...w0..w...........w.0.w
w..w.w.....w..w....0...w...w
w..h.w.w.......w......w....w
wwwwwwwwwww........ww....h.w
w.0..........h...0...w.....w
w....h...ww.......h.....w..w
w..........www.w....ww.....w
www....0...........w...0...w
w0..........h...w.....w...1w
wwwwwwwwwwwwwwwwwwwwwwwwwwww
