wwwwwwwwwwwwwwwwwwwwwwwwwwwwwwwwww
e......w....w....ww..c.w.........w
e....ww..cw...w..c.w..w..........w
e...........w....ww..c..ww.......w
e...ww..A.....w.......w........g.w
e.....ww.cw....c.w..ww...w.......w
e......w...w.ww..w...w.c.ww......w
e....w....w..c.w...w...w.........w
e................................w
wwwwwwwwwwwwwwwwwwwwwwwwwwwwwwwwww