wwwwwwwwwwwwwwwwwwwwwwwwwwwwwwwwww
w...........w.......w...w........e
w.....w..ww...w..ww...w.cww.w....e
w........wc..w.....w..w..........e
w.g.........w...w..A..c.w.w......e
w.....ww......wc......w...ww.....e
w.......ww.wc...w.w....w.c.......e
w.....w..c...ww...c..ww...ww.....e
w........w.......................e
wwwwwwwwwwwwwwwwwwwwwwwwwwwwwwwwww