wwwwwwwwwwwwwwww
wA--..1-1--0...w
w---..-------..w
w010..--,wwww..w
w.........-1-..w
w.......2......w
r..............w
w..............w
w..ww-----.....w
w....-,---wwwwww
w....1-----....w
w0--...........w
w---.0..-w.....w
www...---------w
w.....-000...--g
wwwwwwwwwwwwwwww
