wwwwwwwwwwwwwwww
w0-----A....-w1w
w...........---w
w..............l
r..............w
w.....www...,,ww
w--,........3--w
w---.......2---w
w---.......wwwww
w0--........-,-w
w1--...........l
w......1.....,-w
w............,-w
w.....w-w....--w
w.....wgw....-3w
wwwwwwwwwwwwwwww
