oq.e.e.q.o
o...zx...o
o.w.r.r.wo
oe.....e.o
o........o
o........o
o........o
o........o
o........o
o........o
o........o
o........o
o........o
o........o
o........o
o........o
o........o
o........o
o...A....o