oq.e.e.e.o
oz......xo
o.r.r.r.wo
o........o
o........o
o........o
o........o
o........o
o........o
o........o
o........o
o........o
o........o
o........o
o........o
o........o
o........o
o........o
o...A....o