owweqqewwo
ox.zeex.zo
owwrqqrwwo
oeqe..eqeo
oq......qo
o........o
o........o
o........o
o........o
o........o
o........o
o........o
o........o
o........o
o........o
o........o
o........o
o........o
o...A....o