wwwwwwwwwwwwwwwwwwwwwwwwwwww
we.......w................ew
w..x..........x...0..w.....w
w..........x...w...........w
w......w.w..........x......w
wA....w.......0..w........1w
w.........0...w...w........w
w.........w..w.........0...w
w.....x............w.......w
we........x...............ew
wwwwwwwwwwwwwwwwwwwwwwwwwwww
