wwwwwwwwwwwwwwwwwwwwwwwwwwww
we1..........0.......Aw....w
w.....0...........wwwww....w
wwwwwww...0..............0.w
wx...xw.........0..........w
w..0..w......0.......0.....w
w.0...0....wwwwwww1......0.w
w..........we.........ww0..w
w...0.0....w...........w...w
w.........ww....0....0.w...w
wwwwwwwwwwwwwwwwwwwwwwwwwwww
