wwwwwwwwwwwwwwwwwwwwwwwwwwww
w.11.......................w
w.....x....x..x...x...x....w
w...x...x...x...x...x...x..w
w..........................w
w..............0...0.......w
we.........................w
w.............0....0.......w
w.............0............w
wA.......................e.w
wwwwwwwwwwwwwwwwwwwwwwwwwwww
