wwwwwwwwwwwwwwwwwwwwwwwwwww
w.......i..t++xt.i....i...w
w...i.......+x+.....i.....w
wi....i..i.t+++ti........iw
wt...ttt.t.t+++ttt..tt...tw
w=_====_=====_=========_==w
w========_========_=======w
w===-==========-======-===w
wtt...tt..tt+++tt..t..tt.tw
w.i.........+++...........w
w.....i...itx+lt....s.....w
w...i.....it+++t..........w
wwwwwwwwwwwwwwwwwwwwwwwwwww
