wwwwwwwwwwwwwwwwwwwwwwwwwww
w..i...i..it++xt.....s....w
w....i.....t++xt..........w
w......i....+++...........w
wt.t.t.t.t.t+++ttt..t.t..tw
w=_====_=====_=========_==w
w========_========_=======w
w===-==========-======-===w
wtt..t.t..tt+++t.t.t.t.t.tw
wi....i.....+l+.......i...w
w......i...t+++ti........iw
w..i......it+++t..i...i...w
wwwwwwwwwwwwwwwwwwwwwwwwwww
