wwwwwwwwwwwwwwwwwwwwwwwwwww
w..i...i..it++xt.....s....w
w....i.....t++xt..........w
w......i....+++...........w
wt...ttt.t.t+++ttt..tt...tw
w=__========x_=======_====w
w========_=============_==w
w===-==========--=========w
wtt...tt..tt+++tt..t..tt.tw
wi....i.....+l+.......i...w
w......i...t+++ti........iw
w..i......it+++t..i...i...w
wwwwwwwwwwwwwwwwwwwwwwwwwww
