................
...xxAx.........
..xxxx....b.....
...xx....b...t..
.........b..xx..
...........xxx..
..............p.
.....p..........
...........xxx..
...........xgx..
