.....................
.....................
2...................1
2...................1
2...................1
2...................1
........A...........1
2....................
.............3.......