wwwwwwwwwwwwwwwwwwwwwwwwwwww
wA.......d............w...dw
w.......b........lwwwww....w
wwwwwwwr....w..............w
w..d..w...........w........w
w.....w...........w........w
w.....w....wuwwwwww........w
w..........w..........ww.w.w
w..b.......w..........wr...w
w.........ww..........w..g.w
wwwwwwwwwwwwwwwwwwwwwwwwwwww
