wwwwwwwwwwwwwwwwwwwwwwwwwwwwwww
w...d.............d....d.d....w
w.............................w
wr............................w
w.b.......d..................gw
w...w................b........w
w...dw.......................lw
w.A...........................w
w............u......u.........w
wwwwwwwwwwwwwwwwwwwwwwwwwwwwwww
