wwwwwwwwwwwwwwwwwwwwwwwwwwww
w......d...........d.......w
w.....u.r..................w
wwwwww....r......d.........w
w..d.....w....b............w
w........w...bAb...........w
w........w....b............w
w........wu......l.........w
w........w............l....w
wg.......www.........u.r...w
wwwwwwwwwwwwwwwwwwwwwwwwwwww
