wwwwwwwwwwwwwwwwwwwwwwwwwwww
w...............w.b........w
w.A.............w..........w
wwwwww...wwwww.wwwww..u....w
w........w.................w
w..........................w
w...l....w.................w
w........wwwww.wwwwwwwwwwoww
w.....................w....w
w.............s.......w..g.w
wwwwwwwwwwwwwwwwwwwwwwwwwwww
