wwwwwwwwwwwwwwwwwwwwww
w.......,,,,,,,......w
w.....d.,,,,,,,....l.w
w...d...,,,,,,,..l...w
w.d.....,,,,,,,l.....w
w.......,,,,,,,......w
w.......,,,,,,,......w
w.......,wwwww,......w
w,,,,,,,,w483w,,,,,,,w
w.......,wwwww,.w.w.ww
w.......,,,w,,,.w.w.ww
w.......,,,w,,,......w
ww.w.w.w,,,w,,,ww.wwww
w.......,,,w,,,......w
w.r.b.g.,,,w,,,....A.w
w.......,,,w,,,......w
wwwwwwwwwwwwwwwwwwwwww
