wwwwwwwwwwwww
w...t.......w
w...+.......w
w.+.+.+...++w
w.+.++++..++w
wA@g++..++++w
w.+.++...+++w
w.+.+....+++w
w.+......+++w
w.++++++++++w
wwwwwwwwwwwww