...t.......
...+.......
.+.+.+...++
.+.++++..++
A@g++..++++
.+.++...+++
.+.+....+++
.+......+++
.++++++++++