wwwwwwwwwwwwwwwwwww
ws++++1++000++.+++w
w+000000000000000+w
w+++++++0000+.++++w
w++1++0000000000++w
wA+++0000000++++++w
w+000000000000000+w
w+++000000000000.+w
w++++.++++++.....+w
w++1+++w+++++++++gw
wwwwwwwwwwwwwwwwwww
