wwwwwwwwwwwwwwwwwww
ws++++1+++++++.+++w
w++++++.....+++.++w
w++++++++++++.++++w
w++1+++0+0+++++0++w
w++++0+A+.0+++0+++w
w+++0++.++0++0++++w
w+0++++.++0+0+++.+w
w++++.++++++.....+w
w++++++w+++++++++gw
wwwwwwwwwwwwwwwwwww
