wwwwwwwwwwwwwwwwwww
w+++0+ww+++++++++Aw
w+0+++w+0+++www+++w
w+++++w+++++w+++++w
w+++++w++0++++0+++w
wwww++++++++w++++0w
w++++00+++1+www..ww
w..w++++wwwwwww..ww
w00w++000sw00+++++w
w00w++++++w++++++gw
wwwwwwwwwwwwwwwwwww
