wwwwwwwwwwwwwwwwwwwwwwww
wwwwwwwwwwwwwwwwwwwwwwww
wwwwwwwwwwwwwwwwwwwwwwww
w...n...n...n...n...n..w
w......................w
w......................w
w......................w
w...........A..........w
w......................w
w......................w
w......................w
w......................w
w......................w
w......................w
w......................w
w......................w
w......................w
wwww.www.www.www.www.www
wv...www.www.www.www..vw
wwwwwwww.www.www.wwwwwww
wwwwwwwwvwwwvwwwvwwwwwww
wwwwwwwwwwwwwwwwwwwwwwww
