wwwwwwwwwwwwwwwwwww
w+++++++++++r++++2w
w+r++r++++r+++++++w
w+++r++r+++++r++++w
w++++++r++++r+++++w
w+++r++r++A+++r+++w
wwwwwwwwwwwwwwwwwww
w++r++++++++++++++w
w+++h+v+h+v+h++v++w
w3+r+++r++++++r++gw
wwwwwwwwwwwwwwwwwww
