wwwwwwwwwwwwwwwwwww
wr++++++w+++v+++++w
w++i+v++wi+++++o+Aw
w+++++++w+++++++++w
w++++wwwwwwwwwwwwww
w++h++++++++++2+++w
wwwww+++w+++w+++++w
w+3+w+++w+++w+ww++w
wh++w+v+ov++v+++v+w
wg++w+++w+++++r+++w
wwwwwwwwwwwwwwwwwww
