wwwwwwwwwwwwwwwwwww
wA++w++v++h++w3++gw
wo+iw++++++++wx+++w
wwwww++++++o+wwwwww
w+++++w+r++++++w+ow
w+h+++wwwwwww++++ww
w++r+++x+++++h++++w
wwwww+++++www+++++w
w+++++++++i+++++++w
www2w+++v++++x++www
wwwwwwwwwwwwwwwwwww
