wwwwwwwwwwwwwwww
wt+++++A++++++pw
w...++.....++..w
w..............w
w..............w
w..............w
w..............w
w++++++g+++++++w
w....l.........w
w...++.....++..w
w...++.....pt..w
w...++.....+k..w
wwwwwwwwwwwwwwww
