wwwwwwwwwwwww
ww...w.....ww
ww.w0B.ww.Bww
ww...B.....ww
wwwwww0....ww
www........ww
www..w..w.Aww
www..w..w.0ww
wwwwwwwwwwwww