..wwwwww
..w.OOAw
..w.**.w
..ww.www
...w.w..
...w.w..
wwww.w..
w....ww.
w.w...w.
w...w.w.
www...w.
..wwwww.