wwwwwwwwwwwwwwww
w..............w
w...o++++o++...w
w.+t+++A++++p+.w
w...o++++o++...w
w...++++++++...w
w..............w
w..............w
w++++++g+++++++w
w..............w
w...+....+.....w
w...+....+.....w
wwwwwwwwwwwwwwww
