wwwwwwwwwwwwwwww
w+++t++++p+++.kw
w+++++A+++++++.w
w++++++++++++++w
w+++++++++o++++w
wwwlwwwwwwwwwwww
w+++++wwwwwwwwww
w++++++...+++www
w+o+++.....+++gw
wo++++.....++www
w+++o+.....++++w
wwwwwwwwwwwwwwww
wwwwwwwwwwwwwwww
