wwwwwwwwwwwww
w........w..w
w...B.......w
w...A.B.w.0ww
www.wB..wwwww
w.......w.0.w
w.B........ww
w..........ww
wwwwwwwwwwwww