aaaaaaaaaaaaaaaaaaaaa
.....................
2....................
2....................
2............A.......
2....................
2....................
2....................
..........3.......3..