aaaaaaaaaaaaaaaaaaaaX
.....................
.......... .........1
....................1
....................1
....................1
........A...........1
....................1
.......4....4........