aaaaaaaaaaaaaaaaaaaaa
.....................
2...................1
2...................1
2...................1
2...................1
3.......A...........1
2....................
.....3...4...3......