wwwwwwwwwwwwwwwwwwwwwwwwwwwwwwww
w3ssssslsssssslssssslsssssssss2w
ws.......0000000........00000.sw
ws0..........................0uw
ws0....0...0...0..0..0.......0sw
wd0.....................0.....sw
ws0....0.......A..............uw
ws......................0.....sw
ws.....0.....................0sw
wd0......0...0...0...0..0....0uw
ws0..........................0sw
ws.00.....00.00.00.00....0000.sw
w4sssssrsssssssrsssssssrssssss1w
wwwwwwwwwwwwwwwwwwwwwwwwwwwwwwww
