wwwwwwwwwwwwwwwwwwwwwwwwwwwwwwww
w3ssssslsssssslssssslsssssssss2w
ws.......0000000........00000.sw
ws00..0000..000..000.00.....00uw
ws00........................00sw
wd00......................0...sw
ws00...........A..........0...uw
ws....0...................0...sw
ws....0......................0sw
wd00.........................0uw
ws00...00...0..00..0000....00.sw
ws.0......00.00.00.00....0000.sw
w4sssssrsssssssrsssssssrssssss1w
wwwwwwwwwwwwwwwwwwwwwwwwwwwwwwww
