wwwwwwwwwwwww
w........w..w
w...1.......w
w...A.1.w.0ww
www.w1..wwwww
w.......w.0.w
w.1........ww
w..........ww
wwwwwwwwwwwww