w2.......w
wpp++++ppw
wpp++++ppw
w++p++p++w
w+++pp+++w
wppppApppw
w+++pp+++w
w++p++p++w
wpp++++ppw
wpp++++ppw
w.......1w