w2.......w
w+++bb+++w
w++bbbb++w
w++bbbb++w
w+bb++bb+w
wbbb+Abbbw
w+bb++bb+w
w++bbbb++w
w++bbbb++w
w+++bb+++w
w.......1w