wwwwwwwwwwwwwwww
w.A............w
w..............w
w..............w
w...w...1..w...w
w..........w...w
w.....wwwwww...w
w..............w
w..............w
w..............w
w..wwwwww......w
w..w.......1...w
w..w...........w
w..............w
wwwwwwwwwwwwwwww
