wwwwwwwwwwwwwwwwwww
w+2+++...+ww+++0++w
w+++++-++++++ww+++w
w++wwwwww++++...++w
w0+++.+++++++2++++w
w+++.+.+wwwwww++.+w
wwwwww+++++0++++++w
w+A++w+...+w++.+.+w
w+..+w+++++w+++.++w
w++++.++++-w-+.+.1w
wwwwwwwwwwwwwwwwwww