wwwwwwwwwwwwwwwwwww
w+++++++w.+.+..++.w
w++11+++w+.+2+..++w
w+++2+++w+1++.++++w
w+++1+++wwwwwwww++w
w+++1+++++A+++++++w
w++1++1+wwwwwwww++w
w+++1+++w++-++++++w
w+++1+++w++-+-+-++w
w++1++++w+++-++-++w
wwwwwwwwwwwwwwwwwww