wwwwwwwwwwwwwwwwwww
w1++0w+.+.+++++A++w
w++-+w+.++.+++++++w
w++++w+++w+++wwwwww
w+++++++0w+++..++1w
w+...++www+++..+++w
w++++++++wwww+++++w
w+++w++++w0++++.+.w
w+++w++..+++w+++..w
w-+-w2++..++wwwwwww
wwwwwwwwwwwwwwwwwww