wwwwwwwwwwwwww
w++Aw++++++++w
w+....+++++++w
wU++..++++--gw
w+g....g.++++w
w+++++--...--w
w+++++--...$-w
w+++++--...--w
w+++++-------w
wwwwwwwwwwwwww