wwwwwwwwwww
wcc....cccw
wcc.c..cccw
wc..c.....w
www.w.w.c.w
wg11111..Aw
www.w.w...w
wc..cc..c.w
wcc..c....w
wccc...cccw
wwwwwwwwwww
