wwwwwwwwwwwwww
w............w
w............w
w..c......s..w
w............w
w......A.....w
w............w
w............w
w..b......h..w
w............w
wwwwwwwwwwwwww
