wwwwwwwwwwwwwwwwwwwwwwww
w...w..........0f......w
w.t.w.0..www....f......w
w...w...........f......w
w.0.....A.d.....+e..e..w
w.........ww....ffff+ffw
w..w.......w...........w
w.....ww....0..........w
wwwwwwwwwwwwwwwwwwwwwwww