wwwwwwwwwwwwww
w......w.....w
w...c..w...h.w
w....wwwww...w
w............w
w......A.....w
w..wwww......w
w....kw......w
w..b..wwwwlw.w
w.....ws.....w
wwwwwwwwwwwwww
