wwwwwwwwwwwwww
wA....ww.....w
w.....ww.....w
w..c..ww..s..w
w.....ww.....w
www.wwwwwwlwww
w.....ww.....w
w.....ww.....w
w..b......h..w
w....kww.....w
wwwwwwwwwwwwww
