wwwwwwwwwwwwwwwwwwwwwwww
w..w..f.....f..0.......w
w..w..+e...e+.....A....w
w..0..f..e..f...wwwwww.w
w..d..fff+fff..........w
w.....w.....wwwww..wwwww
www...w...t...0.w...0..w
w.....w......w..w......w
wwwwwwwwwwwwwwwwwwwwwwww