wwwwwwwwwwwwwwww
w......A......3w
w...x..1444...3w
w......1..14444w
w2222221..1....w
w.....w1..1.x..w
w.....w1..1....w
w..w..w1..w....w
w..w..w1..w....w
w..w..w1.ew....w
w..w..w144444hww
w..w..w14444444w
w..w..w1.......w
w.xw...1....x..w
w..w..w1.......w
wwwwwwwwwwwwwwww
