wwwwwwwwwwwwwwww
w..3...........w
w.x3wwww.3..x..w
w..3.....3..344w
w..2222344..3..w
w......3....3..w
w.wwwww3t...3..w
w222222A44444.ew
w.x.1.1.....wwww
w...1.14444....w
w.ww1.....1....w
w...1...x.1....w
w...1wwwww1....w
w...1.....1..x.w
w...1.....1....w
wwwwwwwwwwwwwwww
