wwwwwwwwwwwwwwww
w...n4444......w
w...1..........w
w...1444...34..w
w...1.e.2223...w
w...1444...3...w
w...1..1...3...w
w...1..14444...w
w......1.......w
w.222221..223..w
w....1...x..3..w
w..221......3..w
w...........3..w
w.A4444444444..w
w.1............w
wwwwwwwwwwwwwwww
