wwwwwww
wAwow.w
w.wx..w
w..wxxw
wcc.c.w
w..w..w
wxcx..w
w.....w
wwwwwww