...............................2
..............................12
..............................12
..............................12
...A..........................12
..............................12
..............................12
..............................12
...............................2