w..m.m..n.m.m..n.m.m...w
w......................w
w......................w
w......................w
w......................w
w......................w
w...........A..........w
w......................w
w......................w
w......................w
w...........c..........w
wwwwwwwwwwwwwwwwwwwwwwww