wwwwwwwwwwwwwwwwwwwwwwwwwwwwwwwwwwwwww
w4__l__l______r__r___l_____r____l___2w
w____0__00000_____00000_0000___00_00_w
w__0_000____000_____0_______00_______w
w__nA______________________________e_w
w________000____000_____0_______00___w
w_0000_000___000000___0000___0000___0w
w4_____,_____.___,___.____,__,___.__2w
wwwwwwwwwwwwwwwwwwwwwwwwwwwwwwwwwwwwww
