wwwwwwwwwwwwwwwwwwwwwwwwwwwwwwwwwwwwww
w4_____l______l______l__________l___2w
w____0__00000_____00000_0000___00_00_w
w____________________________________w
w__nA______________________________e_w
w____________________________________w
w_0000_000___000000___0000___0000___0w
w4_____,_____,___,___,_______,______2w
wwwwwwwwwwwwwwwwwwwwwwwwwwwwwwwwwwwwww
