wwwwwwwwwwwwwwwwwwwwwwwwwwwwwwwwwwwwww
w4___l_l___l__l______l____l_____l___2w
w___0_______0_____0a____0_____0____0_w
w___p___________g__________________3_w
w___A________________________________w
wwwwwwwwwwwwwwwwwwwwwwwwwwwwwwwww____w
w____________________________________w
w___e_________________h____________2_w
w____0___0____________0______0___0b__w
w4_____,_____,___,___,__,_,__,___,__2w
wwwwwwwwwwwwwwwwwwwwwwwwwwwwwwwwwwwwww
