wwwwwwwwwwwwwwwwwwwwwwwwwwwwwwwwwwwwww
w4_____l______l______l__________l___2w
w___0___0___0_____0_____0_____0____0_w
w____________________________________w
w___e_____________________________An_w
w____________________________________w
w____0___0_____0______0______0___0___w
w4_____,_____,___,___,_______,______2w
wwwwwwwwwwwwwwwwwwwwwwwwwwwwwwwwwwwwww
