wwwwwwwwwwwwwwwwwwwwwwwwwwwwwwwwwwwwww
w4___l_l___l_________l_l__l_____l___2w
w___0______a0_____0_____0_____0____0_w
w___p___________g__________________3_w
w___A________________________________w
wwwwwwwwwwwwwwwwwwwwwwwwwwwwwwwww____w
w____________________________________w
w___e_________________h____________2_w
w____0___0____________0b_____0___0___w
w4_,___,___,_____,___,__,____,___,__2w
wwwwwwwwwwwwwwwwwwwwwwwwwwwwwwwwwwwwww
