wwwwwwwwwwwwwwwwwwwwwwwwwwwwwwwwwwwwww
w4__l__l______l______l____l_____l___2w
w_______00000_____00000_0000___00_00_w
w____________________________________w
w___e_____________________________An_w
w____________________________________w
w_0000_000___000000___0000___0000___0w
w4_____,_____,_______,____,__,______2w
wwwwwwwwwwwwwwwwwwwwwwwwwwwwwwwwwwwwww
