.....o..
.w....w.
.w.o*.w.
.w.*A*..
....*o..
..www.w.
...o....
