........
.ww...A.
.ww.....
.wwwoww.
.wwwoww.
.wwwwww.
.www.ww.
..*..ww.
..w...w.
..*.w.w.
.ww...w.
........
