wwwwwwwwwwwwwwwwwww
w..xwww.xwx.wwwx..w
w.x...w..w..w.....w
w..www..B.A..www..w
w..w.x...w....xw..w
w..x.....w..x..x..w
w.....wwwwwww.....w
w.x...w.b.o.w....xw
w.....d..w....x...w
wwwwwwwwwwwwwwwwwww